E00WWWWW0W00WWW
0W00000W0WW0W00
00WW0W000W0000W
W000WWWW000W0WW
000W00000WWW00W
WW0WWWW0WW000WW
000WWW0000WW0WW
0W000WW0W0WW00W
0WW0W000W000WWW
W0W00W0WW0WWWWW
W0W0WW0W00WW00W
W000W00W0WW00WW
00WW00W00000WWW
000W00WW0WW0WWW
WWWWWWWW00W000S